49,17,17,17,17,17,17,17,17,225,
33,1,1,1,1,1,1,1,1,65,
33,1,1,1,1,1,1,1,1,65,
33,1,1,1,1,1,1,1,1,65,
33,1,1,1,1,1,1,1,1,65,
33,1,1,1,1,1,1,1,1,65,
33,1,1,1,1,1,1,1,1,65,
33,1,1,1,1,1,1,1,1,65,
33,1,1,1,1,1,1,1,1,65,
161,129,129,1,1,1,1,129,129,193,
0,0,0,225,1,1,49,0,0,0,