34,1,1,1,1,1,1,1,1,2,
33,0,0,0,0,0,0,0,0,65,
33,0,0,0,0,0,0,0,0,65,
33,0,0,0,0,0,0,0,0,65,
33,0,0,0,0,0,0,0,0,65,
33,0,0,0,0,0,0,0,0,65,
33,0,0,0,0,0,0,0,0,65,
33,0,0,0,0,0,0,0,0,65,
33,0,0,0,0,0,0,0,0,65,
98,97,97,97,0,0,97,97,97,66,
128,128,128,65,0,0,33,128,128,128,
